1111111111
1000000001
1111100001
1000000001
1001111111
1000000001
1000000001
1000000001
1111111001
1111111111